.L......
.L......
.L......
.L......
.L......
.L......
.L......
.L......
.L......
.L......
.L......
.L......
.L......
.L......
.L......
.L......
.L......
.L......
.L......
.L......
.L......
.L......
.L......
.L......
.L......
.L......
.L......
.L......
.L......
.L......
.L......
.L......
.L......
.L.....A
........
........
........
........
........
........
........
........
........
........
........
........
........
........
........
........
........
........
........
........
........
........
........
........
........
........
........
........
........
........
........
........
........
........
........
........
........
........
........
........
.L......
.L......
.L.....A
........
........
........
........
........
........
........
........
........
........
........
........
........
........
........
........