|..|............|............|
|..|............|............|
|..|............|............|
|..|............|............|
|..|............|............|
|..|............|............|
|..|...R........|............|
|..|............|............|
|..|............|............|
|..|............|............|
|..|............|............|
|..|............|............|
|..|............|............|
|..|............|............|
|..|............|............|
|..|............|............|
|..|............|............|
|..|............|............|
|..|............|............|
|..|............|............|
|..|............|............|
|..|............|............|
|..|............|............|
|..|............|............|
|..|............|............|
|..|............|............|
|..|............|............|
|..|............|............|
|..|............|............|
|..|............|............|
|..|............|............|
|..|............|............|
|..|............|............|
|..|............|............|
|..|...R........|............|
|..|............|............|
|..|............|............|
|..|............|............|
|..|............|............|
|..|............|............|
|..|............|............|
|..|............|............|
|..|............|............|
|..|............|............|
|..|............|............|
|..|............|............|
|..|............|............|
|..|............|............|
|..|............|............|
|..|............|............|
|..|............|............|
|..|............|............|
|..|............|............|
|..|............|............|
|..|............|............|
|..|............|............|
|..|............|............|
|..|............|............|
|..|............|............|
|..|............|............|
|..|............|............|
|..|............|............|
|..|............|............|
|..|............|............|
|..|............|............|
|..|............|............|
|..|............|............|
|..|............|............|
|..|............|............|
|..|............|............|
|..|............|............|
|..|............|............|
|..|............|............|
|..|............|............|
|..|............|............|
|..|............|............|
|..|............|............|
|..|............|............|
|..|............|............|
|..|............|............|
|..|............|............|
|..|............|............|
|..|............|............|
|..|............|............|
|..|............|............|
|..|............|............|
|..|............|............|
|..|............|............|
|..|............|............|
|..|............|............|
|..|............|............|
|..|............|............|
|..|............|............|
|..|............|............|
|..|............|............|
|..|............|............|
|..|............|............|
|..|............|............|
|..|............|............|
|..|............|............|
|..|............|............|
|..|............|............|
|..|............|............|
|..|............|............|
|..|............|............|
|..|............|............|
|..|............|............|
|..|............|............|
|..|............|............|
|..|............|............|
|..|............|............|
|..|............|............|
|..|............|............|
|..|............|............|
|..|............|............|
|..|............|............|
|..|............|............|
|..|............|............|
|..|............|............|
|..|............|............|
|..|...R........|............|
|..|...R........|............|
|..|............|............|
|..|............|............|
|..|............|............|
|..|............|............|
|..|............|............|
|..|............|............|
|..|............|............|
|..|............|............|
|..|............|............|
|..|............|............|
|..|............|............|
|..|............|............|
|..|............|............|
|..|............|............|
|..|............|............|
|..|............|............|
|..|............|............|
|..|............|............|
|..|...R........|............|
|..|...R........|............|
|..|............|............|
|..|............|............|
|..|............|............|
|..|............|............|
|..|............|............|
|..|............|............|
|..|............|............|
|..|............|............|
|..|............|............|
|..|............|............|
|..|............|............|
|..|............|............|
|..|............|............|
|..|............|............|
|..|............|............|
|..|............|............|
|..|............|............|
|..|............|............|
|..|...R........|............|
|..|...R........|............|
|..|............|............|
|..|............|............|
|..|............|............|
|..|............|............|
|..|............|............|
|..|............|............|
|..|............|............|
|..|............|............|
|..|............|............|
|..|............|............|
|..|............|............|
|..|............|............|
|..|............|............|
|..|...R........|............|
|..|...R........|............|
|..|............|............|
|..|............|............|
|..|............|............|
|..|............|............|
|..|............|............|
|..|............|............|
|..|............|............|
|..|............|............|
|..|............|............|
|..|............|............|
|..|............|............|
|..|............|............|
|..|............|............|
|..|............|............|
|..|............|............|
|..|............|............|
|..|............|............|
|..|............|............|
|..|.........A..|............|
|..|.........A..|............|
|..|............|............|
|..|............|............|
|..|............|............|
|..|............|............|
|..|............|............|
|..|............|............|
|..|............|............|
|..|............|............|
|..|............|............|
|..|............|............|
|..|............|............|
|..|............|............|
|..|............|............|
|..|............|............|
|..|............|............|
|..|............|............|
|..|............|............|
|..|............|............|
|..|............|............|
|..|............|............|
|..|............|............|
|..|............|............|
|..|............|............|
|..|............|............|
|..|............|............|
|..|............|............|
|..|............|............|
|..|............|............|
|..|............|............|
|..|............|............|
|..|............|............|
|..|............|............|
|..|............|............|
|..|............|............|
|..|............|............|
|..|............|............|
|..|............|............|
|..|............|............|
|..|...R........|............|
|..|...R........|............|
|..|............|............|
|..|............|............|
|..|............|............|
|..|............|............|
|..|............|............|
|..|............|............|
|..|............|............|
|..|............|............|
|..|............|............|
|..|............|............|
|..|............|............|
|..|............|............|
|..|............|............|
|..|.D..........|............|
|..|.D..........|............|
|..|............|............|
|..|............|............|
|..|............|............|
|..|............|............|
|..|............|............|
|..|............|............|
|..|............|............|
|..|............|............|
|..|............|............|
|..|............|............|
|..|............|............|
|..|............|............|
|..|............|............|
|..|............|............|
|..|............|............|
|..|............|............|
|..|............|............|
|..|............|............|
|..|............|............|
|..|............|............|
|..|............|............|
|..|............|............|
|..|............|............|
|..|............|............|
|..|............|............|
|..|U...........|............|
|..|............|............|
|..|............|............|
|..|............|............|
|..|............|............|
|..|............|............|
|..|............|............|
|..|............|............|
|..|............|............|
|..|............|............|
|..|............|............|
|..|............|............|
|..|............|............|
|..|............|............|
|..|............|............|
|..|............|............|
|..|............|............|
|..|............|............|
|..|............|............|
|..|............|............|
|..|............|............|
|..|............|............|
|..|............|............|
|..|............|............|
|..|............|............|
|..|............|............|
|..|............|............|
|..|............|............|
|..|............|............|
|..|............|............|
|..|............|............|
|..|............|............|
|..|............|............|
|..|............|............|
|..|............|............|
|..|............|............|
|..|............|............|
|..|............|............|
|..|............|............|
|..|............|............|
|..|............|............|
|..|............|............|
|..|............|............|
|..|............|............|
|..|............|............|
|..|............|............|
|..|............|............|
|..|............|............|
|..|............|............|
|..|............|............|
|..|............|............|
|..|............|............|
|..|............|............|
|..|............|............|
|..|............|............|
|..|............|............|
|..|............|............|
|..|............|............|
|..|............|............|
|..|............|............|
|..|U...........|............|
|..|............|............|
|..|............|............|
|..|............|............|
|..|............|............|
|..|............|............|
|..|............|............|
|..|............|............|
|..|............|............|
|..|............|............|
|..|............|............|
|..|............|............|
|..|............|............|
|..|............|............|
|..|............|............|
|..|............|............|
|..|............|............|
|..|............|............|
|..|............|............|
|..|............|............|
|..|............|............|
|..|............|............|
|..|............|............|
|..|............|............|
|..|............|............|
|..|............|............|
|..|............|............|
|..|............|............|
|..|............|............|
|..|............|............|
|..|............|............|
|..|............|............|
|..|............|............|
|..|............|............|
