|..|............|............|
|..|............|............|
|..|............|............|
|..|............|............|
|..|............|............|
|..|............|............|
|..|............|............|
|..|............|............|
|..|............|............|
|..|............|............|
|..|............|............|
|..|............|............|
|..|............|............|
|..|............|............|
|..|............|............|
|..|............|............|
|..|............|............|
|..|............|............|
|..|............|............|
|..|............|............|
|..|............|............|
|..|............|............|
|..|............|............|
|..|............|............|
|..|............|............|
|..|............|............|
|..|............|............|
|..|............|............|
|..|............|............|
|..|............|............|
|..|............|............|
|..|............|............|
|..|............|............|
|..|............|............|
|..|............|............|
|..|............|............|
|..|............|............|
|..|............|............|
|..|............|............|
|..|............|............|
|..|............|............|
|..|............|............|
|..|............|............|
|..|............|............|
|..|............|............|
|..|............|............|
|..|............|............|
|..|............|............|
|..|............|............|
|..|............|............|
|..|............|............|
|..|............|............|
|..|............|............|
|..|............|............|
|..|...R........|............|
|..|............|............|
|..|............|............|
|..|............|............|
|..|............|............|
|..|............|............|
|..|............|............|
|..|............|............|
|..|............|............|
|..|............|............|
|..|............|............|
|..|............|............|
|..|............|............|
|..|............|............|
|..|............|............|
|..|............|............|
|..|............|............|
|..|............|............|
|..|............|............|
|..|............|............|
|..|............|............|
|..|............|............|
|..|............|............|
|..|............|............|
|..|............|............|
|..|............|............|
|..|............|............|
|..|............|............|
|..|...R........|............|
|..|............|............|
|..|............|............|
|..|............|............|
|..|............|............|
|..|............|............|
|..|............|............|
|..|............|............|
|..|............|............|
|..|............|............|
|..|............|............|
|..|............|............|
|..|............|............|
|..|............|............|
|..|............|............|
|..|............|............|
|..|...R........|............|
|..|............|............|
|..|............|............|
|..|............|............|
|..|............|............|
|..|............|............|
|..|............|............|
|..|............|............|
|..|............|............|
|..|............|............|
|..|............|............|
|..|............|............|
|..|............|............|
|..|............|............|
|..|............|............|
|..|............|............|
|..|...R........|............|
|..|............|............|
|..|............|............|
|..|............|............|
|..|............|............|
|..|............|............|
|..|............|............|
|..|............|............|
|..|............|............|
|..|............|............|
|..|............|............|
|..|............|............|
|..|............|............|
|..|............|............|
|..|............|............|
|..|............|............|
|..|............|............|
|..|............|............|
|..|............|............|
|..|...R...B....|............|
|..|...R...B....|............|
|..|............|............|
|..|............|............|
|..|............|............|
|..|............|............|
|..|............|............|
|..|............|............|
|..|............|............|
|..|............|............|
|..|............|............|
|..|............|............|
|..|............|............|
|..|............|............|
|..|............|............|
|..|............|............|
|..|............|............|
|..|............|............|
|..|............|............|
|..|............|............|
|..|............|............|
|..|............|............|
|..|............|............|
|..|............|............|
|..|............|............|
|..|............|............|
|..|............|............|
|..|............|............|
|..|............|............|
|..|............|............|
|..|............|............|
|..|............|............|
|..|............|............|
|..|............|............|
|..|............|............|
|..|............|............|
|..|............|............|
|..|............|............|
|..|............|............|
|..|............|............|
|..|............|............|
|..|............|............|
|..|............|............|
|..|............|............|
|..|............|............|
|..|............|............|
|..|............|............|
|..|............|............|
|..|............|............|
|..|............|............|
|..|............|............|
|..|............|............|
|..|............|............|
|..|............|............|
|..|............|............|
|..|............|............|
|..|............|............|
|..|............|............|
|..|............|............|
|..|............|............|
|..|............|............|
|..|............|............|
|..|............|............|
|..|............|............|
|..|............|............|
|..|............|............|
|..|............|............|
|..|............|............|
|..|............|............|
|..|............|............|
|..|............|............|
|..|............|............|
|..|............|............|
|..|............|............|
|..|............|............|
|..|............|............|
|..|............|............|
|..|............|............|
|..|............|............|
|..|............|............|
|..|............|............|
|..|............|............|
|..|............|............|
|..|............|............|
|..|............|............|
|..|............|............|
|..|............|............|
|..|............|............|
|..|............|............|
|..|............|............|
|..|............|............|
|..|............|............|
|..|............|............|
|..|............|............|
|..|............|............|
|..|............|............|
|..|............|............|
|..|U...........|............|
|..|............|............|
|..|............|............|
|..|............|............|
|..|............|............|
|..|............|............|
|..|............|............|
|..|............|............|
|..|............|............|
|..|............|............|
|..|............|............|
