|..|............|............|
|..|............|............|
|..|..L.........|............|
|..|............|............|
|..|............|............|
|..|............|............|
|..|............|............|
|..|............|............|
|..|............|............|
|..|............|............|
|..|............|............|
|..|............|............|
|..|............|............|
|..|............|............|
|..|............|............|
|..|............|............|
|..|............|............|
|..|............|............|
|..|............|............|
|..|............|............|
|..|............|............|
|..|............|............|
|..|............|............|
|..|............|............|
|..|............|............|
|..|............|............|
|..|............|............|
|..|............|............|
|..|............|............|
|..|............|............|
|..|............|............|
|..|............|............|
|..|............|............|
|..|............|............|
|..|............|............|
|..|............|............|
|..|............|............|
|..|............|............|
|..|............|............|
|..|............|............|
|..|............|............|
|..|............|............|
|..|............|............|
|..|............|............|
|..|............|............|
|..|............|............|
|..|............|............|
|..|............|............|
|..|............|............|
|..|............|............|
|..|............|............|
|..|............|............|
|..|............|............|
|..|............|............|
|..|U...........|............|
|..|............|............|
|..|............|............|
|..|............|............|
|..|............|............|
|..|............|............|
|..|............|............|
|..|............|............|
|..|............|............|
|..|............|............|
|..|............|............|
|..|............|............|
|..|............|............|
|..|............|............|
|..|............|............|
|..|............|............|
|..|............|............|
|..|............|............|
|..|............|............|
|..|............|............|
|..|............|............|
|..|............|............|
|..|............|............|
|..|............|............|
|..|............|............|
|..|............|............|
|..|............|............|
|..|............|............|
|..|............|............|
|..|............|............|
|..|............|............|
|..|............|............|
|..|............|............|
|..|............|............|
|..|............|............|
|..|............|............|
|..|............|............|
|..|............|............|
|..|............|............|
|..|............|............|
|..|............|............|
|..|............|............|
|..|............|............|
|..|............|............|
|..|............|............|
|..|............|............|
|..|............|............|
|..|............|............|
|..|............|............|
|..|............|............|
|..|............|............|
|..|............|............|
|..|............|............|
|..|............|............|
|..|............|............|
|..|............|............|
|..|............|............|
|..|............|............|
|..|............|............|
|..|............|............|
|..|............|............|
|..|............|............|
|..|............|............|
|..|............|............|
|..|............|............|
|..|............|............|
|..|............|............|
|..|............|............|
|..|............|............|
|..|............|............|
|..|U...........|............|
|..|............|............|
|..|............|............|
|..|............|............|
|..|............|............|
|..|............|............|
|..|............|............|
|..|............|............|
|..|............|............|
|..|............|............|
|..|............|............|
|..|............|............|
|..|............|............|
|..|............|............|
|..|............|............|
|..|............|............|
|..|............|............|
|..|............|............|
|..|............|............|
|..|............|............|
|..|............|............|
|..|............|............|
|..|............|............|
|..|............|............|
|..|............|............|
|..|............|............|
|..|............|............|
|..|............|............|
|..|............|............|
|..|............|............|
|..|............|............|
|..|............|............|
|..|............|............|
|..|............|............|
|..|............|............|
|..|............|............|
|..|............|............|
|..|............|............|
|..|............|............|
|..|............|............|
|..|............|............|
|..|............|............|
|..|............|............|
|..|............|............|
|..|............|............|
|..|............|............|
|..|............|............|
|..|............|............|
|..|............|............|
|..|............|............|
|..|............|............|
|..|............|............|
|..|............|............|
|..|............|............|
|..|............|............|
|..|............|............|
|..|............|............|
|..|............|............|
|..|............|............|
|..|............|............|
|..|............|............|
|..|............|............|
|..|............|............|
|..|............|............|
|..|............|............|
|..|............|............|
|..|............|............|
|..|............|............|
|..|............|............|
|..|............|............|
|..|............|............|
|..|............|............|
|..|..L.........|............|
|..|............|............|
|..|............|............|
|..|............|............|
|..|............|............|
|..|............|............|
|..|............|............|
|..|............|............|
|..|............|............|
|..|............|............|
|..|............|............|
|..|............|............|
|..|............|............|
|..|............|............|
|..|............|............|
|..|............|............|
|..|............|............|
|..|............|............|
|..|............|............|
|..|............|............|
|..|............|............|
|..|............|............|
|..|............|............|
|..|............|............|
|..|............|............|
|..|............|............|
|..|............|............|
|..|............|............|
|..|..L.........|............|
|..|............|............|
|..|............|............|
|..|............|............|
|..|..L....B....|............|
|..|............|............|
|..|............|............|
|..|............|............|
|..|............|............|
|..|............|............|
|..|............|............|
|..|............|............|
|..|............|............|
|..|............|............|
|..|............|............|
|..|............|............|
|..|............|............|
|..|............|............|
|..|............|............|
|..|............|............|
|..|............|............|
|..|............|............|
|..|............|............|
|..|............|............|
|..|............|............|
|..|............|............|
|..|............|............|
|..|............|............|
|..|............|............|
|..|............|............|
|..|............|............|
|..|............|............|
|..|............|............|
|..|............|............|
|..|............|............|
|..|............|............|
|..|............|............|
|..|............|............|
|..|............|............|
|..|............|............|
|..|............|............|
|..|............|............|
|..|............|............|
|..|............|............|
|..|............|............|
|..|............|............|
|..|............|............|
|..|............|............|
|..|............|............|
|..|............|............|
|..|............|............|
|..|............|............|
|..|..L....B....|............|
|..|............|............|
|..|............|............|
|..|............|............|
|..|............|............|
|..|............|............|
|..|............|............|
|..|............|............|
|..|............|............|
|..|............|............|
|..|............|............|
|..|............|............|
|..|............|............|
|..|............|............|
|..|............|............|
|..|............|............|
|..|............|............|
|..|............|............|
|..|............|............|
|..|............|............|
|..|............|............|
|..|............|............|
|..|............|............|
|..|............|............|
|..|............|............|
|..|............|............|
|..|............|............|
|..|............|............|
|..|............|............|
|..|............|............|
|..|............|............|
|..|............|............|
|..|............|............|
|..|............|............|
|..|............|............|
|..|............|............|
|..|............|............|
|..|............|............|
