|..|............|............|
|..|............|............|
|..|............|............|
|..|............|............|
|..|............|............|
|..|............|............|
|..|............|............|
|..|............|............|
|..|............|............|
|..|............|............|
|..|............|............|
|..|............|............|
|..|............|............|
|..|............|............|
|..|............|............|
|..|............|............|
|..|............|............|
|..|............|............|
|..|............|............|
|..|............|............|
|..|............|............|
|..|............|............|
|..|............|............|
|..|............|............|
|..|............|............|
|..|............|............|
|..|............|............|
|..|............|............|
|..|............|............|
|..|............|............|
|..|............|............|
|..|............|............|
|..|............|............|
|..|............|............|
|..|............|............|
|..|............|............|
|..|............|............|
|..|............|............|
|..|............|............|
|..|............|............|
|..|............|............|
|..|............|............|
|..|.......B....|............|
|..|............|............|
|..|............|............|
|..|............|............|
|..|............|............|
|..|............|............|
|..|............|............|
|..|............|............|
|..|............|............|
|..|............|............|
|..|............|............|
|..|............|............|
|..|............|............|
|..|............|............|
|..|............|............|
|..|............|............|
|..|............|............|
|..|............|............|
|..|............|............|
|..|............|............|
|..|............|............|
|..|............|............|
|..|............|............|
|..|............|............|
|..|............|............|
|..|............|............|
|..|............|............|
|..|............|............|
|..|............|............|
|..|............|............|
|..|............|............|
|..|............|............|
|..|............|............|
|..|............|............|
|..|............|............|
|..|............|............|
|..|............|............|
|..|............|............|
|..|............|............|
|..|............|............|
|..|............|............|
|..|............|............|
|..|............|............|
|..|............|............|
|..|............|............|
|..|............|............|
|..|............|............|
|..|............|............|
|..|............|............|
|..|............|............|
|..|............|............|
|..|............|............|
|..|............|............|
|..|............|............|
|..|............|............|
|..|............|............|
|..|............|............|
|..|............|............|
|..|............|............|
|..|............|............|
|..|...R.....A..|............|
|..|............|............|
|..|............|............|
|..|............|............|
|..|............|............|
|..|............|............|
|..|............|............|
|..|............|............|
|..|............|............|
|..|............|............|
|..|............|............|
|..|............|............|
|..|............|............|
|..|............|............|
|..|............|............|
|..|............|............|
|..|............|............|
|..|............|............|
|..|............|............|
|..|............|............|
|..|............|............|
|..|............|............|
|..|............|............|
|..|............|............|
|..|............|............|
|..|............|............|
|..|............|............|
|..|............|............|
|..|............|............|
|..|............|............|
|..|............|............|
|..|............|............|
|..|............|............|
|..|............|............|
|..|.........A..|............|
|..|.........A..|............|
|..|............|............|
|..|............|............|
|..|............|............|
|..|............|............|
|..|............|............|
|..|............|............|
|..|............|............|
|..|............|............|
|..|............|............|
|..|............|............|
|..|............|............|
|..|............|............|
|..|............|............|
|..|............|............|
|..|............|............|
|..|............|............|
|..|............|............|
|..|............|............|
|..|............|............|
|..|............|............|
|..|............|............|
|..|............|............|
|..|............|............|
|..|............|............|
|..|............|............|
|..|............|............|
|..|............|............|
|..|............|............|
|..|............|............|
|..|............|............|
|..|............|............|
|..|............|............|
|..|............|............|
|..|............|............|
|..|............|............|
|..|............|............|
|..|............|............|
|..|............|............|
|..|............|............|
|..|............|............|
|..|............|............|
|..|............|............|
|..|............|............|
|..|............|............|
|..|............|............|
|..|............|............|
|..|............|............|
|..|............|............|
|..|............|............|
|..|............|............|
|..|............|............|
|..|............|............|
|..|............|............|
|..|............|............|
|..|............|............|
|..|............|............|
|..|............|............|
|..|............|............|
|..|............|............|
|..|............|............|
|..|............|............|
|..|............|............|
|..|............|............|
|..|............|............|
|..|............|............|
|..|............|............|
|..|............|............|
|..|............|............|
|..|............|............|
|..|............|............|
|..|............|............|
|..|............|............|
|..|............|............|
|..|............|............|
|..|............|............|
|..|............|............|
|..|............|............|
|..|............|............|
|..|............|............|
|..|............|............|
|..|............|............|
|..|............|............|
|..|............|............|
|..|............|............|
|..|............|............|
|..|............|............|
|..|............|............|
|..|............|............|
|..|............|............|
|..|..L......A..|............|
|..|............|............|
|..|............|............|
|..|............|............|
|..|............|............|
|..|............|............|
|..|............|............|
|..|............|............|
|..|............|............|
|..|............|............|
|..|............|............|
|..|............|............|
|..|............|............|
|..|............|............|
|..|............|............|
|..|............|............|
|..|..L.........|............|
|..|............|............|
|..|............|............|
|..|............|............|
|..|............|............|
|..|............|............|
|..|............|............|
|..|............|............|
|..|............|............|
|..|............|............|
|..|............|............|
|..|............|............|
|..|............|............|
|..|............|............|
|..|............|............|
|..|............|............|
|..|............|............|
|..|............|............|
|..|............|............|
|..|............|............|
|..|............|............|
|..|............|............|
|..|............|............|
|..|............|............|
|..|............|............|
|..|............|............|
|..|............|............|
|..|............|............|
|..|..L....B....|............|
|..|............|............|
|..|............|............|
|..|............|............|
|..|............|............|
|..|............|............|
|..|............|............|
|..|............|............|
|..|............|............|
|..|............|............|
|..|............|............|
|..|............|............|
|..|............|............|
|..|............|............|
|..|............|............|
|..|............|............|
|..|............|............|
|..|............|............|
|..|............|............|
|..|............|............|
|..|............|............|
|..|............|............|
|..|............|............|
|..|............|............|
|..|............|............|
|..|............|............|
|..|............|............|
|..|............|............|
|..|............|............|
|..|............|............|
|..|............|............|
|..|............|............|
|..|............|............|
|..|............|............|
|..|............|............|
|..|............|............|
|..|............|............|
|..|............|............|
|..|............|............|
|..|............|............|
|..|............|............|
|..|............|............|
|..|............|............|
|..|............|............|
|..|............|............|
|..|............|............|
|..|............|............|
|..|............|............|
|..|............|............|
